10
B.P.B.-.-.-.-.-.-.-
-.B.-.-.-.-.-.B.-.-
-.-.B.-.-.-.B.P.B.-
-.B.P.B.-.-.-.B.G.-
-.-.B.-.S.-.-.-.-.-
-.-.-.S.W.S.B.-.G.-
-.-.S.-.S.B.P.B.-.-
-.S.W.S.-.-.BSG.-.-.-
-.-.S.-.-.S.W.S.-.-
-.-.-.-.-.-.S.-.-.G


