10
B.P.B.-.G.S.-.-.-.-
G.B.-.-.S.W.S.B.-.-
G.G.B.-.G.SG.B.P.B.-
G.B.P.B.-.-.-.B.G.-
S.-.B.-.S.-.-.-.-.-
W.SG.-.S.W.S.B.-.G.-
S.-.S.-.S.B.P.B.B.-
-.S.W.S.-.-.BSG.B.P.B
-.-.S.-.-.S.W.S.B.-
G.G.-.A.-.-.S.-.-.G


