10
-.S.-.B.P.GB.-.S.-.-
S.W.S.-.B.-.S.W.S.B
-.S.BG.-.-.G.-.S.B.P
-.B.P.B.-.-.S.-.G.B
-.-.BS.-.A.S.W.S.-.-
G.S.W.S.B.-.S.-.B.-
-.-.SG.B.P.B.-.B.P.B
G.-.S.-.B.-.-.GS.B.-
G.SG.W.S.-.-.S.W.S.-
G.G.S.-.G.-.-.S.-.G